# This puzzle is solvable
20
 76 142  75  80   5 207 143 211  84 150 212  11 308  87 216  17  16  94  20 161
203   3 204  79 208  83   1  10 152 153 306 146 265  86  14  90  99 217  95  26
144  78 257  77 301 147   2   8  82  89 368   7 154 158  18 310  93  19 311  12
140 141 145 255 252 148  81 259 305 262  88 160  85  15 218 215  21  25  22  97
  4 201 256 254 300 303 214 339   6 213 151 309 155 267 156  96 220  24  23  92
 71 297  74 205 206 298 398 251 335 260 307 209 159 346 270 343 163 340  29  28
 72 299 138 325  73 200 266 210 264 302 369 367  98 342 390 219 344  30 166 164
202 295 139 149  70 199 263 258 341   9 366 271 387 272 347 157  91 103 221  33
 69  67  66 198 362 330 296 364 379 365 396 268 391 167 222 269 228 102 100 170
134 293  68 334 338 250 360 328 361 283 354 313 345 312 386 315  34  27 225 101
 64   0 249 247 137 371 288 331 337 336 395 385 382 162 314 224 104 223 173 165
 65 132 292 248 378 380 324 332 388 399 372 304 373 389 273 393 172 348 168 370
 57 135 196  61 329 363 394 376 280 319 294 377 355 353 349 350 274 106  31  35
253 136 197  63 243 326 327 286 287 384 282 397 276 235 318 275  13 375 229 107
133 130  60  62 333 261 381 291 285 352 241 238  44 169 230 317 226 374  36  32
244 190 246 195 124 189 120 187 356 359 320 236 279 351 316 113 232 175 234 227
245 191 192 126 193  53 185 242 237 323 322 114 284 177 278 321  43 111 110 105
128 131 357 358  55  52 290  46 240 119  48 231 392 171 112 115 277 174 109 108
 59 129 127  54 289  49 121 183 181  50 179 233 383 281 182  45 116 178  37  39
 58  56 125 194 186 188 122 184 123  51 118 239 180  47 117  42  40 176  38  41
